###################################################
#.......#.....................#.............#.....#
#######.#######.#####.#########.#####.#######.###.#
#.....#.#.......#...#.#...#.....#.#...#.......#...#
#.###.#.#.#######.#.#.#.#.#.#####.#.#.#.#######.###
#...#...#...#.....#.#.#.#...#.....#.#.#.#.....#...#
###.#####.#.#.#####.###.#####.###.#.###.#.#######.#
#.#.#.#...#.#.#...#...#.#.....#...#...#...#.....#.#
#.#.#.#.###.#.#.#.###.#.###.#########.#.###.###.#.#
#...#.#.#.#.#.#.#.....#.#...#.........#.#...#.#.#.#
#.###.#.#.#.#.#.#######.#.###.#########.#.###.#.#.#
#...#.....#.#.#.#.......#...#...........#.#.....#.#
###.#######.#.#.#.#########.#############.#.#####.#
#.#.#.....#...#.#.#.........#.#.....#.....#...#...#
#.#.#.###.#.###.#.#.#####.#.#.#.###.#.#######.###.#
#.#...#.#.#...#.#.#...#...#.#.#.#...#.......#.....#
#.#####.#.###.#.#.#####.###.#.#.#.#########.#######
#.......#.#...#.........#.#.#...#.#.......#.#.....#
#####.#.#.###############.#.#.###.#.#.###.#.#.###.#
#...#.#.#.............#...#.#.#.#...#.#.#.#...#...#
#.#.#.#.#############.#.#.#.#.#.#####.#.#.#####.#.#
#.#...#...#...........#.#...#.....#...#...#.....#.#
#.#########.#############.#######.#.###.###.#####.#
#...#.....#.............#.#.......#.#...#.#.#...#.#
#.#.#.###.#############.#.#########.#.###.#.#.#.#.#
#.#.#.#.#.............#.#.#.......#.#.#...#...#.#.#
#.#.#.#.#######.#######.#.#.#####.#.#.###.#####.#.#
#.#.#...#.......#.......#...#.......#.....#.#...#.#
#.#.###.#.#####.#.#######.#########.#####.#.#.###.#
#.#...#.#.#.....#.#.#.....#.....#...#...#...#...#.#
#.#.###.#.#######.#.#.#####.###.#####.#.###.###.#.#
#.#...#.#.........#...#.....#.#.#...#.#.#...#...#.#
#.###.#.###########.###.#####.#.#.#.#.#.#.###.#####
#.#.#.#...#.........#.#.#.#...#...#...#.#.#.#.....#
#.#.#.###.###.#######.#.#.#.#.#########.#.#.#####.#
#.#.#...#...#.#.......#.#...#.#.......#.#...#...#.#
#.#.###.###.#.#####.###.###.#.#.#.###.#.###.#.#.#.#
#.....#...#.#.....#...#...#.#...#.#...#...#...#.#.#
###.###.#.#.#####.###.###.#.#####.#######.#####.#.#
#.#.#...#.#.#...#...#...#.#...#...#...#...#.#...#.#
#.#.#.###.#.###.###.###.#.#.###.#.#.#.#.###.#.###.S
#...#.#...#.#...#.......#.#.#...#.#.#...#.......#.#
#.###.#.###.#.###.#######.###.###.#.#########.###.#
#...#.#...#.#...#.#.#.....#...#...#.........#.#...#
#####.#####.#.#.#.#.#.#####.###############.###.#.#
#...#.#...#.#.#.....#...#.#...#.......#...#...#.#.#
#.#.#.#.#.#.#.#####.###.#.#.#.#.###.#.#.#.###.#.###
#.#...#.#...#.#...#.#...#...#.#.#.#.#.#.#...#.#...#
#.#####.#######.#.###.###.###.#.#.#.###.###.#.###.#
#...............#.....#.....#.....#.......#.......#
#####################G#############################