#####################
#.#.......#.........#
#.###.###.###.#####.#
#.....#.#...#.....#.#
#######.###.#.###.#.#
#.....#.....#.#...#.#
###.#.#.#####.#.###.#
#...#.#.#.#...#...#.#
S.#####.#.#.#####.#.#
#...#...#.......#.#.#
###.#.#######.###.#.#
#...#.....#...#...#.G
#.#######.#####.###.#
#.......#.#.....#...#
#####.#.#.#.#####.###
#...#.#.#.#.....#...#
#.#.###.#.#.###.#####
#.#.....#.#...#.....#
#.#######.#########.#
#...................#
#####################